R      1000 800
NO        ./pics/bluestone.xpm


SO ./pics/colorstone.xpm
WE ./pics/greystone.xpm


EA ./pics/redbrick.xpm
S           ./pics/barrel.xpm
F         220,100,0

C     225,30,0
111111111111111111
100001210000000001
100000000000000001
100000000000000001
1100000N0000000011
11111111111111111111121
        10000000000222221100011
100000000000000001
100000001210000001
1111111111111111110001
10001

