R 1000 900
NO ./pics/bluestone.xpm
SO ./pics/colorstone.xpm
WE ./pics/greystone.xpm
EA ./pics/redbrick.xpm
S ./pics/barrel.xpm
F 220,100,0
C 225,200,0
1111111111111111111111111
100011110110000000000001
1000000111
101211000111111111111111
1000000000111011011111111111
100101111000000000000000011111111
111101111011000001110000000000001
10000000001100N001110111111111111
11110111111111011100000010001
11110111111111011101010010001
11000000110101011100000010001
10001000000000001100000010001
10000000000000001101010010001
11000001110101011111011110N0111
11110111 1110101 101111010001
11111111 1111111 111111111111
